.........................
S.....V.................S
S.......................S
S.......................S
S............S..........S
S.......^SPPPSPPPPS^^...S
S.....SSSSSSSSSSSSSSS...S
S....S..S...V...........S
S.......S...............S
SS......S.............^^S
SS^^....S...SSSSSSSSSSSSS
SSSSSS..S...SV..........S
S.......S...S...........S
S......^S...............S
S....SSSS...............S
S....SSSS............SSSS
.....SSSS......?.....S..S
.....SSSSPPPSSSS?....X..S
SSSSSSSSSSSSSSSSSSSSSSSSS
