SSSSSSSSSSSSSSSSSSSSSSSSS
S.......................S
S.......................S
S.......................S
S.......................S
S.......................S
S.......................S
S.......................S
S.......................S
S.......................S
S.......................S
S.......................S
S.......................S
S.......................S
S.....S.................S
S.....S.................S
......S.........S.......S
......S.........S.......S
SSSSSSSSSSSSSSSSSSSSSSSSS
