.........................
S.....?.................S
S.......................S
S.......................S
S............S..........S
S.......XSPPPSPPPPSXX...S
S....SSSSSSSSSSSSSSSS...S
S...SS..S...?...........S
S.......S...............S
S.......S.............XXS
S.XXXS..S...SSSSSSSSSSSSS
SSSSSS..S...S?..........S
S.......S...S...........S
S......XS...............S
S....SSSS...............S
S....SSSS............SSSS
.....SSSS......?.....S..S
.....SSSSPPPSSSS?....V..S
SSSSSSSSSSSSSSSSSSSSSSSSS
