.........................
S.VVV......S............S
S..........S............S
S..........S............S
S.......................S
S.......................S
S..........S............S
S........^^S^^^^S^^^^...S
S....SSSSSSSSSSSSSSSS...S
S....V..............S...S
S...................S...S
S...................S...S
S^^^..........^^....S...S
SSSSSSSSSSSSSSSS....S...S
S...................S...S
S...................S...S
.........S..........S...S
.........S.......^^^S...S
SSSSSSSSSSSSSSSSSSSSSSSSS
