.........................
S.V......V...V..V....SVVS
S.......................S
S.....S.................S
S....SS..S......S...SS??S
S...SSSPPSPPPSPPSPPPSS..S
S...SSSSSSSSSSSSSSSSSS..S
S...S................S..S
S...S................S..S
S......SS.........S..S..S
S......SSS........S..S..S
SS.....S........SSS..S..S
S......S...S.........S..S
S....S.S.............S..S
SPPPPSPS............SS..S
SSSSSSSS.......S.....S..S
...............S.....S..S
...........^S^^S^^^^^S..S
SSSSSSSSSSSSSSSSSSSSSSSSS
