.........................
S.......................S
S.......................S
S.......................S
S.......................S
S.......................S
S.......................S
S.......................S
S.......................S
S.......................S
S.......................S
S.......................S
S.......................S
S.......................S
S.......................S
S.......................S
........................S
.............S..........S
SSSSPPPPSPPPPSPPPPPSSSSSS
