.........................
.........................
.........................
.........................
.........................
.........................
.........................
.........................
.........................
.........................
.........................
.........................
.........................
.........................
.........................
.........................
............G............
............D............
GGGGGGGGGGGGDGGGGGGGGGGGG
