.........................
S..........S............S
S..........S............S
S..........S............S
S.......................S
S.......................S
S..........S............S
S........XXSXXXXSXXXX...S
S....SSSSSSSSSSSSSSSS...S
S...................S...S
S...................S...S
S...................S...S
SXXX..........XX....S...S
SSSSSSSSSSSSSSSS....S...S
S...................S...S
S...................S...S
.........S..........S...S
.........S.......XXXS...S
SSSSSSSSSSSSSSSSSSSSSSSSS
