.........................
SVVSSSS..........VV..V.VS
S...V.V.................S
S.........SS............S
S........SV...........?.S
S....................SS.S
S......SSS..^..^........S
S......S....SSSS....S..?S
S....SSS.........SS.....S
S......S.............?..S
SSS....S..SS............S
S......S...............?S
S....SSS................S
S......S.....S.......?..S
SS.....S........^.......S
SSS....S.......SSS.S...?S
.....SSS...............SS
.....SSSPPPPPPPPPPPPS.X.S
SSSSSSSSSSSSSSSSSSSSSSSSS
